XXXXXXXXXX
X*OOOOOO*X
XOXXOOXXOX
XOOOOOOOOX
XPXABCDXOX
XOXXXXXXOX
XOOOOOOOOX
XOXOOOOXOX
XOOOOOOOOX
XXXXXXXXXX